19 11
#####
# #
#$ #
### $##
# $ $ #
### # ## # ######
# # ## ##### ..#
# $ $ ..#
##### ### #@## ..#
# #########
#######