10 7
##########
#        #
# $    @ #
#    #   #
# .      #
#        #
##########
